??????????
??????????
??????│???
???┌──┼┐??
???│??■┤??
???└┬─┴┘??
????╵?????
??????????
??????????
??????????
