??????????
??????■???
??????│???
???┌──┼┐??
???│??■┤??
???└┬─┴┘??
????╵?????
??????????
??????????
??????????
